answer
{'sol': 'd'}
{'sol': 'a'}
{'sol': 'd'}
{'sol': 'a'}
{'sol': 'd'}
{'sol': 'b'}
{'sol': 'a'}
{'sol': 'a'}
{'sol': 'd'}
{'sol': 'c'}
{'sol': 'a'}
{'sol': 'd'}
{'sol': 'b'}
{'sol': 'b'}
{'sol': 'b'}
{'sol': 'd'}
{'sol': 'c'}
{'sol': 'c'}
{'sol': 'a'}
{'sol': 'a'}
{'sol': 'a'}
{'sol': 'd'}
{'sol': 'a'}
{'sol': 'a'}
{'sol': 'a'}
{'sol': 'a'}
{'sol': 'a'}
{'sol': 'd'}
{'sol': 'c'}
{'sol': 'd'}
{'sol': 'd'}
{'sol': 'a'}
{'sol': 'a'}
{'sol': 'a'}
{'sol': 'a'}
{'sol': 'a'}
{'sol': 'a'}
{'sol': 'b'}
{'sol': 'a'}
{'sol': 'c'}
{'sol': 'b'}
{'sol': 'c'}
{'sol': 'a'}
{'sol': 'a'}
{'sol': 'd'}
{'sol': 'c'}
{'sol': 'a'}
{'sol': 'd'}
{'sol': 'c'}
{'sol': 'd'}
{'sol': 'a'}
{'sol': 'b'}
{'sol': 'c'}
{'sol': 'c'}
{'sol': 'a'}
{'sol': 'b'}
{'sol': 'b'}
{'sol': 'c'}
{'sol': 'b'}
{'sol': 'b'}
{'sol': 'b'}
{'sol': 'b'}
{'sol': 'b'}
{'sol': 'a'}
{'sol': 'b'}
{'sol': 'c'}
{'sol': 'a'}
{'sol': 'a'}
{'sol': 'a'}
{'sol': 'b'}
{'sol': 'c'}
{'sol': 'c'}
{'sol': 'b'}
{'sol': 'a'}
{'sol': 'a'}
{'sol': 'c'}
{'sol': 'c'}
{'sol': 'c'}
{'sol': 'c'}
{'sol': 'c'}
{'sol': 'b'}
{'sol': 'b'}
{'sol': 'c'}
{'sol': 'c'}
{'sol': 'a'}
{'sol': 'a'}
{'sol': 'a'}
{'sol': 'a'}
{'sol': 'a'}
{'sol': 'a'}
{'sol': 'b'}
{'sol': 'b'}
{'sol': 'd'}
{'sol': 'c'}
{'sol': 'd'}
{'sol': 'a'}
{'sol': 'a'}
{'sol': 'c'}
{'sol': 'd'}
{'sol': 'b'}
{'sol': 'b'}
{'sol': 'a'}
{'sol': 'a'}
{'sol': 'b'}
{'sol': 'c'}
{'sol': 'a'}
{'sol': 'a'}
{'sol': 'c'}
{'sol': 'c'}
{'sol': 'c'}
{'sol': 'b'}
{'sol': 'a'}
{'sol': 'a'}
{'sol': 'b'}
{'sol': 'b'}
{'sol': 'c'}
{'sol': 'a'}
{'sol': 'd'}
{'sol': 'a'}
{'sol': 'b'}
{'sol': 'a'}
{'sol': 'c'}
{'sol': 'b'}
{'sol': 'c'}
{'sol': 'c'}
{'sol': 'c'}
{'sol': 'd'}
{'sol': 'b'}
{'sol': 'c'}
{'sol': 'd'}
{'sol': 'c'}
{'sol': 'd'}
{'sol': 'b'}
{'sol': 'c'}
{'sol': 'c'}
{'sol': 'b'}
{'sol': 'a'}
{'sol': 'a'}
{'sol': 'd'}
{'sol': 'c'}
{'sol': 'c'}
{'sol': 'c'}
{'sol': 'd'}
{'sol': 'b'}
{'sol': 'b'}
{'sol': 'c'}
{'sol': 'c'}
{'sol': 'c'}
{'sol': 'd'}
{'sol': 'd'}
{'sol': 'c'}
{'sol': 'c'}
{'sol': 'b'}
{'sol': 'b'}
{'sol': 'd'}
{'sol': 'd'}
{'sol': 'c'}
{'sol': 'a'}
{'sol': 'b'}
{'sol': 'c'}
{'sol': 'b'}
{'sol': 'a'}
{'sol': 'b'}
{'sol': 'c'}
{'sol': 'a'}
{'sol': 'a'}
{'sol': 'a'}
{'sol': 'c'}
{'sol': 'b'}
{'sol': 'b'}
{'sol': 'a'}
